################################################################################################
#..............................................................................................#
#..............................................................................................#
#..............................................................................................#
#..............................................................................................#
#..............................................................................................#
#..............................................................................................#
#..............................................................................................#
#..............................................................................................#
#..............................................................................................#
#..............................................................................................#
#..............................................................................................#
#..............................................................................................#
#..............................................................................................#
#..............................................................................................#
#..............................................................................................#
#..............................................................................................#
#...J.....S.....................################################################################
################################################################################################

