################################################
#..............................................#
#..............................................#
#..............................................#
#..............................................#
#.................D............................#
#..............................................#
#..............................................#
#..............................................#
#..............................................#
#..............................................#
#..............................................#
#..............................................#
#..................S...........................#
#..............................................#
#..............................................#
#..............................................#
#..............................................#
################################################
